#################X###############################X#############################
#        #           ##                         # #   #          #####        #
### ###  #  ####    ##  ############### ######### ##      #      #####   ######
#   #    #  #      ##   #     ##      # #         #  ######  #########   #    #
#   #    #  #     ##    #   # ## #    #           #  #    #      #       #### X
#   #    #  #    ##     #   #    #    # #         #  #    #      #       #    #
#####    #  #   ##      ##########      #         #    #######   #####   #    #
#        #  #  ##                #    # #  ###    #    #       # #####   #### #
#######  #  # ##  ######         #    # #  ###    #    #       # #####        #
#        #  ###   ################    ###  ########    #  #### #     #   ######
#        #  ##    ######              ###  ###         #  #### #     #   ######
#        #  #     ######              ########   #######  #### #######   ######
##### ####        ######      #######            #######     # #     #   #    #
#                 ######      #####      #        #          #       #        #
########################      ###       S####     ###        ####    # ########
X        #        #           #       ####          #           #      #      #
#        #        #           #          #          ########### ########      #
#### #####   ##   #    ########          ###### ######              #  ###### #
#    #       ##        #    #     #####       #     #####   #####   #         #
#    #####   ##        #    #     #   #       # ######          #   #    ##   #
#            ##   #    #          #   #       ####              ########### ###
###############   #    ############   #  ######        #######      #       ###
#                 #                   #       #        #                      X
###############################################################################